^^^^^^^^2^2^2~~~~~~~
^^^^^^^^2^2^2~~~~~~~
^^^^^^^^2^2^2~~~~~~~
^^^^^^^^2^2^2~~~~~~~
444434444^2^2~~~~~~~
^^^^^^^^^^2^2~~~~~~~
44443444444^24443444
^^^^^^^^^^^^^^^^^^^^
44443444444444444444
----5---------------
----5---------------
55555555555555555555
--------------------
--------------------
--------------------
11111111111111111111
oooooooooooooooooooo
oooooooooooooooooooo
oooooooooooooooooooo
oooooooooooooooooooo