^^^^^^^^2^2^2~~~~~~~
^^^^^^^^2^2^2~~~~~~~
^^^^^^^^2^2^2~~~~~~~
^^^^^^^^2^2^2~~~~~~~
444434444^2^2~~~~~~~
^^^^^^^^^^2^2~~~~~~~
44443444444^2~~~~~~~
^^^^^^^^^^^^2~~~~~~~
44443444444444443444
--------------------
--------------------
--------------------
--------------------
--------------------
--------------------
11111111111111111111
oooooooooooooooooooo
oooooooooooooooooooo
oooooooooooooooooooo
oooooooooooooooooooo