^^^^^^^^^^^^4-------
^^^^^^^^^^^4--------
^^^^^^^^^^4---------
^^^^^^^^^4----------
^^^^^^^^4-----------
~~~~~~~~------------
~~~~~~~-------------
~~~~~~--------------
~~~~~--------------1
~~~~--------------13
~~~--------------12o
~~--------------12oo
~--------------12ooo
--------------12oooo
-------------12ooooo
------------12oooooo
-----------12ooooooo
----------12oooooooo
---------12ooooooooo
--------13oooooooooo
