^^^^^^^^2^2^--------
^^^^^^^^2^2^--------
^^^^^^^^2^2^--------
^^^^^^^^2^2^55555555
444434444^2^----5---
^^^^^^^^^^2^----5---
44443444444^----5---
^^^^^^^^^^^^----5---
44444444444444443444
~~~~~~~~~~~-----5---
~~~~~~~~~~~-----5---
~~~~~~~~~~~555555555
~~~~~~~~~~~---------
~~~~~~~~~~~---------
~~~~~~~~~~~---------
11111111111111111111
oooooooooooooooooooo
oooooooooooooooooooo
oooooooooooooooooooo
oooooooooooooooooooo